0000000000000000000000000000000000
0000000000000000000000000000000000
0000000000000000000000000000000000
0000000000000002200001111111000000
0000000000000002200001111111000000
0000000000000002200000000000000000
0000000000000002200000000000000000
0000222220000000000000000000000000
0000222220000000000000000000000000
0000000000000000000000000000000000
0000000000000000000000000000000000
0000000003333000000000000000000000
0000000003333000000000000000000000
0000000003333000000000000000000000
0000000003333000000000000000000000
0000000003333000000000000000000000
0000000000000000000000000000000000
0000000000000000111111111100000000
0000000000000000111111111100000000
0000000000000000000000000000000000
0000000000000000000000000000000000
0000000220000004444444440000000000
0000000220000004444444440000000000
0000000000000000000000000000000000
0000000000000111111000000000000000
0000000000000111111000000000000000
000000000000011ff11000000000000000
000000000000011ff11000000000000000